27 27 27 27 27 27 27 27 27 27 27 27 27 27 27 27 27 27 27 27 27 27 27 27 27 27 27 27 27 27 27 27 27 27 27 27 27 27 27 27 27 27 27 27 27 27 27 27 27 27 
27 27 27 27 27 27 27 27 27 27 27 27 27 27 27 27 27 27 27 27 27 27 27 27 27 27 27 27 27 27 27 27 27 27 27 27 27 27 27 27 27 27 27 27 27 27 27 27 27 27 
27 27 27 27 27 27 27 27 27 27 27 27 27 27 27 27 27 27 27 27 27 27 27 27 27 27 27 27 27 27 27 27 27 27 27 27 27 27 27 27 27 27 27 27 27 27 27 27 27 27 
27 27 27 27 27 27 27 27 27 27 27 27 27 27 27 27 27 27 27 27 27 27 27 27 27 27 27 27 27 27 27 27 27 27 27 27 27 27 27 27 27 27 27 27 27 27 27 27 27 27 
27 27 27 27 27 27 27 27 27 27 27 27 17 23 24 19 17 18 19 17 18 19 17 18 19 17 18 19 17 18 19 17 18 19 17 18 19 17 18 19 27 27 27 27 27 27 27 27 27 27 
27 27 27 27 27 27 27 27 27 27 27 27 20 25 26 22 20 21 22 20 21 22 20 21 22 20 21 22 20 21 22 20 21 22 20 21 22 20 21 22 27 27 27 27 27 27 27 27 27 27 
27 27 27 27 27 27 27 27 27 27 9 10 9 10 9 10 9 10 9 10 9 10 9 10 9 10 9 10 9 10 9 10 9 10 9 10 9 10 9 10 27 27 27 27 27 27 27 27 27 27 
27 27 27 27 27 27 27 27 27 27 11 12 11 12 11 12 11 12 11 12 11 12 11 12 11 12 11 12 11 12 11 12 11 12 11 12 11 12 11 12 27 27 27 27 27 27 27 27 27 27 
27 27 27 27 27 27 27 27 27 27 9 10 9 10 9 10 9 10 9 10 9 10 9 10 9 10 9 10 9 10 9 10 9 10 9 10 9 10 9 10 27 27 27 27 27 27 27 27 27 27 
27 27 27 27 27 27 27 27 27 27 11 12 11 12 11 12 11 12 11 12 11 12 11 12 11 12 11 12 11 12 11 12 11 12 11 12 11 12 11 12 27 27 27 27 27 27 27 27 27 27 
27 27 27 27 27 27 27 27 27 27 9 10 9 10 27 27 27 27 9 10 9 10 9 10 9 10 27 27 27 27 27 27 27 27 9 10 9 10 27 27 27 27 27 27 27 27 27 27 27 27 
27 27 27 27 27 27 27 27 27 27 11 12 11 12 27 27 27 27 11 12 11 12 11 12 11 12 27 27 27 27 27 27 27 27 11 12 11 12 27 27 27 27 27 27 27 27 27 27 27 27 
27 27 27 27 27 27 27 27 27 27 9 10 9 10 27 27 27 27 9 10 9 10 9 10 9 10 27 27 27 27 27 27 27 27 9 10 9 10 27 27 27 27 27 27 27 27 27 27 27 27 
27 27 27 27 27 27 27 27 27 27 11 12 11 12 27 27 27 27 11 12 11 12 11 12 11 12 27 27 27 27 27 27 27 27 11 12 11 12 27 27 27 27 27 27 27 27 27 27 27 27 
27 27 27 27 27 27 27 27 27 27 9 10 9 10 27 27 27 27 9 10 9 10 9 10 9 10 27 27 27 27 27 27 27 27 11 10 9 10 27 27 27 27 27 27 27 27 27 27 27 27 
27 27 27 27 27 27 27 27 27 27 11 12 11 12 27 27 27 27 11 12 11 12 11 12 11 12 27 27 27 27 27 27 27 27 11 12 11 12 27 27 27 27 27 27 27 27 27 27 27 27 
27 27 27 27 27 27 27 27 27 27 9 10 9 10 27 27 27 27 9 10 9 10 9 10 9 10 27 27 27 27 27 27 27 27 9 10 9 10 27 27 27 27 27 27 27 27 27 27 27 27 
27 27 27 27 27 27 27 27 27 27 11 12 11 12 27 27 27 27 11 12 11 12 11 12 11 12 27 27 27 27 27 27 27 27 11 12 11 12 27 27 27 27 27 27 27 27 27 27 27 27 
27 27 27 27 27 27 27 27 27 27 9 10 9 10 27 27 27 27 9 10 9 10 9 10 9 10 27 27 27 27 27 27 27 27 9 10 9 10 27 27 27 27 27 27 27 27 27 27 27 27 
27 27 27 27 27 27 27 27 27 27 11 12 11 12 27 27 27 27 11 12 11 12 11 12 11 12 27 27 27 27 27 27 27 27 11 12 11 12 27 27 27 27 27 27 27 27 27 27 27 27 
27 27 27 27 27 27 27 27 27 27 9 10 9 10 27 27 27 27 9 10 9 10 9 10 9 10 27 27 27 27 9 10 9 10 9 10 9 10 27 27 27 27 27 27 27 27 27 27 27 27 
27 27 27 27 27 27 27 27 27 27 11 12 11 12 27 27 27 27 11 12 11 12 11 12 11 12 27 27 27 27 11 12 11 12 11 12 11 12 27 27 27 27 27 27 27 27 27 27 27 27 
27 27 27 27 27 27 27 27 27 27 9 10 9 10 27 27 27 27 9 10 9 10 9 10 9 10 27 27 27 27 9 10 9 10 9 10 9 10 27 27 27 27 27 27 27 27 27 27 27 27 
27 27 27 27 27 27 27 27 27 27 11 12 11 12 27 27 27 27 11 12 11 12 11 12 11 12 27 27 27 27 11 12 11 12 11 12 11 12 27 27 27 27 27 27 27 27 27 27 27 27 
27 27 27 27 27 27 27 27 27 27 9 10 9 10 9 10 27 27 11 12 11 12 11 12 11 12 27 27 27 27 9 10 9 10 9 10 9 10 27 27 27 27 27 27 27 27 27 27 27 27 
27 27 27 27 27 27 27 27 27 27 11 12 11 12 11 12 27 27 9 10 9 10 9 10 9 10 27 27 27 27 11 12 11 12 11 12 11 12 27 27 27 27 27 27 27 27 27 27 27 27 
27 27 27 27 27 27 27 27 27 27 9 10 9 10 9 10 27 27 11 12 11 12 11 12 11 12 27 27 27 27 9 10 9 10 9 10 9 10 27 27 27 27 27 27 27 27 27 27 27 27 
27 27 27 27 27 27 27 27 27 27 11 12 11 12 11 12 27 27 9 10 9 10 9 10 9 10 27 27 27 27 11 12 11 12 11 12 11 12 27 27 27 27 27 27 27 27 27 27 27 27 
27 27 27 27 27 27 27 27 27 27 27 27 27 27 27 27 27 27 11 12 11 12 11 12 11 12 27 27 27 27 9 10 9 10 9 10 9 10 27 27 27 27 27 27 27 27 27 27 27 27 
27 27 27 27 27 27 27 27 27 27 27 27 27 27 27 27 27 27 9 10 9 10 9 10 9 10 27 27 27 27 11 12 11 12 11 12 11 12 27 27 27 27 27 27 27 27 27 27 27 27 
27 27 27 27 27 27 27 27 27 27 27 27 27 27 27 27 27 27 11 12 11 12 11 12 11 12 27 27 27 27 9 10 9 10 9 10 9 10 27 27 27 27 27 27 27 27 27 27 27 27 
27 27 27 27 27 27 27 27 27 27 27 27 27 27 27 27 27 27 9 10 9 10 9 10 9 10 27 27 27 27 11 12 11 12 11 12 11 12 27 27 27 27 27 27 27 27 27 27 27 27 
27 27 27 27 27 27 27 27 27 27 27 27 27 27 27 27 27 27 11 12 11 12 11 12 11 12 27 27 27 27 9 10 9 10 9 10 9 10 27 27 27 27 27 27 27 27 27 27 27 27 
27 27 27 27 27 27 27 27 27 27 27 27 27 27 27 27 27 27 9 10 9 10 9 10 9 10 27 27 27 27 11 12 11 12 11 12 11 12 27 27 27 27 27 27 27 27 27 27 27 27 
27 27 27 27 27 27 27 27 27 27 27 27 27 27 27 27 27 27 11 12 11 12 11 12 11 12 27 27 27 27 9 10 9 10 9 10 9 10 27 27 27 27 27 27 27 27 27 27 27 27 
27 27 27 27 27 27 27 27 27 27 27 27 27 27 27 27 27 27 9 10 9 10 9 10 9 10 27 27 27 27 11 12 11 12 11 12 11 12 27 27 27 27 27 27 27 27 27 27 27 27 
27 27 27 27 27 27 27 27 27 27 27 27 27 27 27 27 27 27 11 12 11 12 11 12 11 12 27 27 27 27 9 10 9 10 9 10 9 10 27 27 27 27 27 27 27 27 27 27 27 27 
27 27 27 27 27 27 27 27 27 27 27 27 27 27 27 27 27 27 9 10 9 10 9 10 9 10 27 27 27 27 11 12 11 12 11 12 11 12 27 27 27 27 27 27 27 27 27 27 27 27 
27 27 27 27 27 27 27 27 27 27 27 27 27 27 27 27 27 27 12 12 11 12 11 12 11 12 27 27 27 27 9 10 9 10 9 10 9 10 27 27 27 27 27 27 27 27 27 27 27 27 
27 27 27 27 27 27 27 27 27 27 27 27 27 27 27 27 27 27 9 10 9 10 9 10 9 10 27 27 27 27 11 12 11 12 11 12 11 12 27 27 27 27 27 27 27 27 27 27 27 27 
27 27 27 27 27 27 27 27 27 27 27 27 27 27 27 27 27 27 11 12 11 12 11 12 11 12 27 27 27 27 27 27 27 27 27 27 27 27 27 27 27 27 27 27 27 27 27 27 27 27 
27 27 27 27 27 27 27 27 27 27 27 27 27 27 27 27 27 27 9 10 9 10 9 10 9 10 27 27 27 27 27 27 27 27 27 27 27 27 27 27 27 27 27 27 27 27 27 27 27 27 
27 27 27 27 27 27 27 27 27 27 27 27 27 27 27 27 27 27 11 12 11 12 11 12 11 12 27 27 27 27 27 27 27 27 27 27 27 27 27 27 27 27 27 27 27 27 27 27 27 27 
27 27 27 27 27 27 27 27 27 27 9 10 9 10 9 10 9 10 9 10 9 10 9 10 9 10 9 10 9 10 9 10 9 10 9 10 9 10 9 10 27 27 27 27 27 27 27 27 27 27 
27 27 27 27 27 27 27 27 27 27 11 12 11 12 11 12 11 12 11 12 28 29 11 12 11 12 11 12 11 12 11 12 11 12 11 12 11 12 11 12 27 27 27 27 27 27 27 27 27 27 
27 27 27 27 27 27 27 27 27 27 27 27 27 27 27 27 27 27 27 27 30 31 27 27 27 27 27 27 27 27 27 27 27 27 27 27 27 27 27 27 27 27 27 27 27 27 27 27 27 27 
27 27 27 27 27 27 27 27 27 27 27 27 27 27 27 27 27 27 27 27 27 27 27 27 27 27 27 27 27 27 27 27 27 27 27 27 27 27 27 27 27 27 27 27 27 27 27 27 27 27 
27 27 27 27 27 27 27 27 27 27 27 27 27 27 27 27 27 27 27 27 27 27 27 27 27 27 27 27 27 27 27 27 27 27 27 27 27 27 27 27 27 27 27 27 27 27 27 27 27 27 
27 27 27 27 27 27 27 27 27 27 27 27 27 27 27 27 27 27 27 27 27 27 27 27 27 27 27 27 27 27 27 27 27 27 27 27 27 27 27 27 27 27 27 27 27 27 27 27 27 27 
27 27 27 27 27 27 27 27 27 27 27 27 27 27 27 27 27 27 27 27 27 27 27 27 27 27 27 27 27 27 27 27 27 27 27 27 27 27 27 27 27 27 27 27 27 27 27 27 27 27 
