62 62 62 62 62 62 62 62 62 62 62 62 62 62 62 62 62 62 62 62 62 62 62 62 62 62 62 62 62 62 62 62 62 62 62 62 62 62 62 62 62 62 62 62 62 62 62 62 62 62 
62 62 62 62 62 62 62 62 62 62 62 62 62 62 62 62 62 62 62 62 62 62 62 62 62 62 62 62 62 62 62 62 62 62 62 62 62 62 62 62 62 62 62 62 62 62 62 62 62 62 
62 62 62 62 62 62 62 62 62 62 62 62 62 62 62 62 62 62 62 62 62 62 62 62 62 62 62 62 62 62 62 62 62 62 62 62 62 62 62 62 62 62 62 62 62 62 62 62 62 62 
62 62 62 62 62 62 62 62 62 62 62 62 62 62 62 62 62 62 62 62 62 62 62 62 62 62 62 62 62 62 62 62 62 62 62 62 62 62 62 62 62 62 62 62 62 62 62 62 62 62 
62 62 62 62 62 62 62 62 62 62 62 62 62 62 62 62 62 62 62 62 62 62 62 62 62 62 62 62 62 62 62 62 62 62 62 62 62 62 62 62 62 62 62 62 62 62 62 62 62 62 
62 62 62 62 62 62 62 62 62 62 62 62 62 62 62 62 62 62 62 62 62 62 62 62 62 62 62 62 62 62 62 62 62 62 62 62 62 62 62 62 62 62 62 62 62 62 62 62 62 62 
62 62 62 62 62 62 62 62 62 62 62 62 62 62 62 62 62 62 62 62 62 62 62 62 62 62 62 62 62 62 62 62 62 62 62 62 62 62 62 62 62 62 62 62 62 62 62 62 62 62 
62 62 62 62 62 62 62 62 58 58 58 58 58 58 58 58 58 58 58 58 58 58 58 58 58 48 49 58 58 58 58 58 58 58 58 58 58 58 58 58 58 58 62 62 62 62 62 62 62 62 
62 62 62 62 62 62 62 59 32 52 53 33 52 53 32 52 53 33 52 53 32 52 53 33 32 50 51 33 32 52 53 33 52 53 32 52 53 33 52 53 32 33 61 62 62 62 62 62 62 62 
62 62 62 62 62 62 62 59 34 36 37 35 36 37 34 36 37 35 36 37 34 36 37 35 34 35 34 35 34 36 37 35 36 37 34 36 37 35 36 37 34 35 61 62 62 62 62 62 62 62 
62 62 62 62 62 62 62 59 32 38 39 33 38 39 32 38 39 33 38 39 32 38 39 33 32 33 32 33 32 38 39 33 38 39 32 38 39 33 38 39 32 33 61 62 62 62 62 62 62 62 
62 62 62 62 62 62 62 59 68 64 66 35 34 35 34 35 34 35 34 35 34 35 34 35 34 35 34 35 34 35 34 35 34 35 34 35 34 35 34 42 40 54 61 62 62 62 62 62 62 62 
62 62 62 62 62 62 62 59 67 63 65 33 32 33 32 33 32 33 32 33 32 33 32 33 32 33 32 33 32 33 32 33 32 33 32 33 32 33 32 43 41 55 61 62 62 62 62 62 62 62 
62 62 62 62 62 62 62 59 34 35 34 35 34 35 34 35 34 35 34 35 34 35 34 35 34 35 34 35 34 35 34 35 34 35 34 35 34 35 34 35 34 35 61 62 62 62 62 62 62 62 
62 62 62 62 62 62 62 59 68 64 66 33 32 33 32 33 32 33 32 33 32 33 32 33 32 33 32 33 32 33 32 33 32 33 32 33 32 33 32 42 40 54 61 62 62 62 62 62 62 62 
62 62 62 62 62 62 62 59 67 63 65 35 34 35 34 35 34 35 34 35 34 35 34 35 34 35 34 35 34 35 34 35 34 35 34 35 34 35 34 43 41 55 61 62 62 62 62 62 62 62 
62 62 62 62 62 62 62 59 32 33 32 33 32 33 32 33 32 33 32 33 32 33 32 33 32 33 32 33 32 33 32 33 32 33 32 33 32 33 32 33 32 33 61 62 62 62 62 62 62 62 
62 62 62 62 62 62 62 59 68 64 66 35 34 35 34 35 34 35 34 35 34 35 34 35 34 35 34 35 34 35 34 35 34 35 34 35 34 35 34 42 40 54 61 62 62 62 62 62 62 62 
62 62 62 62 62 62 62 59 67 63 65 33 32 33 32 33 32 33 32 33 32 33 32 33 32 33 32 33 32 33 32 33 32 33 32 33 32 33 32 43 41 55 61 62 62 62 62 62 62 62 
62 62 62 62 62 62 62 59 34 35 34 35 34 35 34 35 34 35 34 35 34 35 34 35 34 35 34 35 34 35 34 35 34 35 34 35 34 35 34 35 34 35 61 62 62 62 62 62 62 62 
62 62 62 62 62 62 62 59 68 64 66 33 32 33 32 33 32 33 32 33 32 33 32 33 32 33 32 33 32 33 32 33 32 33 32 33 32 33 32 42 40 54 61 62 62 62 62 62 62 62 
62 62 62 62 62 62 62 59 67 63 65 35 34 35 34 35 34 35 34 35 34 35 34 35 34 35 34 35 34 35 34 35 34 35 34 35 34 35 34 43 41 55 61 62 62 62 62 62 62 62 
62 62 62 62 62 62 62 59 32 33 32 33 32 33 32 33 32 33 32 33 32 33 32 33 32 33 32 33 32 33 32 33 32 33 32 33 32 33 32 33 32 33 61 62 62 62 62 62 62 62 
62 62 62 62 62 62 62 59 68 64 66 35 34 35 34 35 34 35 34 35 34 35 34 35 34 35 34 35 34 35 34 35 34 35 34 35 34 35 34 42 40 54 61 62 62 62 62 62 62 62 
62 62 62 62 62 62 62 59 67 63 65 33 32 33 32 33 32 33 32 33 32 33 32 33 32 33 32 33 32 33 32 33 32 33 32 33 32 33 32 43 41 55 61 62 62 62 62 62 62 62 
62 62 62 62 62 62 62 59 34 35 34 35 34 35 34 35 34 35 34 35 34 35 34 35 34 35 34 35 34 35 34 35 34 35 34 35 34 35 34 35 34 35 61 62 62 62 62 62 62 62 
62 62 62 62 62 62 62 59 68 64 66 33 32 33 32 33 32 33 32 33 32 33 32 33 32 33 32 33 32 33 32 33 32 33 32 33 32 33 32 42 40 54 61 62 62 62 62 62 62 62 
62 62 62 62 62 62 62 59 67 63 65 35 34 35 34 35 34 35 34 35 34 35 34 35 34 35 34 35 34 35 34 35 34 35 34 35 34 35 34 43 41 55 61 62 62 62 62 62 62 62 
62 62 62 62 62 62 62 59 32 33 32 33 32 33 32 33 32 33 32 33 32 33 32 33 32 33 32 33 32 33 32 33 32 33 32 33 32 33 32 33 32 33 61 62 62 62 62 62 62 62 
62 62 62 62 62 62 62 59 68 64 66 35 34 35 34 35 34 35 34 35 34 35 34 35 34 35 34 35 34 35 34 35 34 35 34 35 34 35 34 42 40 54 61 62 62 62 62 62 62 62 
62 62 62 62 62 62 62 59 67 63 65 33 32 33 32 33 32 33 32 33 32 33 32 33 32 33 32 33 32 33 32 33 32 33 32 33 32 33 32 43 41 55 61 62 62 62 62 62 62 62 
62 62 62 62 62 62 62 59 34 35 34 35 34 35 34 35 34 35 34 35 34 35 34 35 34 35 34 35 34 35 34 35 34 35 34 35 34 35 34 35 34 35 61 62 62 62 62 62 62 62 
62 62 62 62 62 62 62 59 68 64 66 33 32 33 32 33 32 33 32 33 32 33 32 33 32 33 32 33 32 33 32 33 32 33 32 33 32 33 32 42 40 54 61 62 62 62 62 62 62 62 
62 62 62 62 62 62 62 59 67 63 65 35 34 35 34 35 34 35 34 35 34 35 34 35 34 35 34 35 34 35 34 35 34 35 34 35 34 35 34 43 41 55 61 62 62 62 62 62 62 62 
62 62 62 62 62 62 62 59 32 33 32 33 32 33 32 33 32 33 32 33 32 33 32 33 32 33 32 33 32 33 32 33 32 33 32 33 32 33 32 33 32 33 61 62 62 62 62 62 62 62 
62 62 62 62 62 62 62 59 68 64 66 35 34 35 34 35 34 35 34 35 34 35 34 35 34 35 34 35 34 35 34 35 34 35 34 35 34 35 34 42 40 54 61 62 62 62 62 62 62 62 
62 62 62 62 62 62 62 59 67 63 65 33 32 33 32 33 32 33 32 33 32 33 32 33 32 33 32 33 32 33 32 33 32 33 32 33 32 33 32 43 41 55 61 62 62 62 62 62 62 62 
62 62 62 62 62 62 62 59 34 35 34 35 34 35 34 35 34 35 34 35 34 35 34 35 34 35 34 35 34 35 34 35 34 35 34 35 34 35 34 35 34 35 61 62 62 62 62 62 62 62 
62 62 62 62 62 62 62 59 68 64 66 33 32 33 32 33 32 33 32 33 32 33 32 33 32 33 32 33 32 33 32 33 32 33 32 33 32 33 32 42 40 54 61 62 62 62 62 62 62 62 
62 62 62 62 62 62 62 59 67 63 65 47 46 35 47 46 34 47 46 35 47 46 34 47 46 35 47 46 34 47 46 35 47 46 34 47 46 35 34 43 41 55 61 62 62 62 62 62 62 62 
62 62 62 62 62 62 62 59 32 33 32 45 44 33 45 44 32 45 44 33 45 44 32 45 44 33 45 44 32 45 44 33 45 44 32 45 44 33 32 33 32 33 61 62 62 62 62 62 62 62 
62 62 62 62 62 62 62 59 34 35 34 57 56 35 57 56 34 57 56 35 57 56 34 57 56 35 57 56 34 57 56 35 57 56 34 57 56 35 34 35 34 35 61 62 62 62 62 62 62 62 
62 62 62 62 62 62 62 62 60 60 60 60 60 60 60 60 60 60 60 60 60 60 60 60 60 60 60 60 60 60 60 60 60 60 60 60 60 60 60 60 60 60 62 62 62 62 62 62 62 62 
62 62 62 62 62 62 62 62 62 62 62 62 62 62 62 62 62 62 62 62 62 62 62 62 62 62 62 62 62 62 62 62 62 62 62 62 62 62 62 62 62 62 62 62 62 62 62 62 62 62 
62 62 62 62 62 62 62 62 62 62 62 62 62 62 62 62 62 62 62 62 62 62 62 62 62 62 62 62 62 62 62 62 62 62 62 62 62 62 62 62 62 62 62 62 62 62 62 62 62 62 
62 62 62 62 62 62 62 62 62 62 62 62 62 62 62 62 62 62 62 62 62 62 62 62 62 62 62 62 62 62 62 62 62 62 62 62 62 62 62 62 62 62 62 62 62 62 62 62 62 62 
62 62 62 62 62 62 62 62 62 62 62 62 62 62 62 62 62 62 62 62 62 62 62 62 62 62 62 62 62 62 62 62 62 62 62 62 62 62 62 62 62 62 62 62 62 62 62 62 62 62 
62 62 62 62 62 62 62 62 62 62 62 62 62 62 62 62 62 62 62 62 62 62 62 62 62 62 62 62 62 62 62 62 62 62 62 62 62 62 62 62 62 62 62 62 62 62 62 62 62 62 
62 62 62 62 62 62 62 62 62 62 62 62 62 62 62 62 62 62 62 62 62 62 62 62 62 62 62 62 62 62 62 62 62 62 62 62 62 62 62 62 62 62 62 62 62 62 62 62 62 62 
62 62 62 62 62 62 62 62 62 62 62 62 62 62 62 62 62 62 62 62 62 62 62 62 62 62 62 62 62 62 62 62 62 62 62 62 62 62 62 62 62 62 62 62 62 62 62 62 62 62 
